3 13 31
###############################
#p  ** **   1 *   2      l    #
# # # #*# # # # # # # # # # # #
#*     ** * *  *   * ** 3 *   #
# # # # # #*# # # # # # #*# # #
#*   *s*    *** * x **   b    #
# # # # # # # # # # # # # #*# #
#   1*  b  *   4    * 2  **  3#
# #*# # #*#*#*#*# # #1# # #*# #
#   1    *   *2*  3 *   *     #
#*# # # # # # # # # # #*# # #*#
# *    * **    ** ***     1   #
###############################