2 13 31
###############################
#p   ** **    *   2           #
# # # #*# # # # # # # # # # # #
#*     ** * *  *f  * ** 3 *   #
# # # # # #*# # # # # # #*# # #
#*   *s*    *** * x **        #
# # # # # # # # # # # # # #*# #
#    *     *    l   *    **  3#
#*#*#*#*#*#*#*#*# # #1# # #*# #
#    2   *   *2*    *   *     #
#*# # # # # # # # # # #*# # #*#
# *    * **    ** ***     1   #
###############################