5 13 31
###############################
#p     b* *  3  *   *  * * *  #
# #*# #s# # #*#*# # # #*#*#*# #
#* *  *     * *s *   f**  * * #
# #*# # # #*# # #*#*# # #*# #*#
#     5  x* **  *f *    4     #
# # # # # #*# # # #*# # # # # #
#*1 s      *  *      *    l   #
# # # # #*# # # #*#*# #b# # # #
#*    **  *   2   *     *  5  #
# #*# # # # # # #*# # # # #f# #
#    2      *   *  *    *     #
###############################